놓 써요	놓아요
놓에요	놓아요
각뿔라고	각뿔이라고
나타낸에요	나타낸거에요
나타낸답에요	나타낸거에요
예 세로까요	예를 들어볼까요
이이에요	이에요
나타내봐볼게요	나타내볼게요
로쳐요	로 만들어요
하하면	하면
않 않	않
않않	않
뜻이에봐요	뜻이에요
뜻이에볼까요	뜻이에요
대합니다	의미합니다
받게아요	받게 되었어요
받게 합니다	받게 됩니다
푼까요	풀어요
푼 써요	풀어요
푼써요	풀어요
푼아요	풀어요
푼 볼까요	풀어볼까요
해해요	해요
같은 같아요	같아요
대각각선	대각선
삼형	삼각형
활용 활용	활용
다음 다음	다음
이이죠	이죠
같아보세요	같아요
는는	는
는 는	는
길이일습니다	길이라고 하면
찾아보게요	찾아볼게요
이항를	이항을
일정 일정	일정
나타낸입니다	나타낸 것 입니다
쉽요	쉬워요
꼴꼴	꼴
작요	작아요
작세요	작아요
반복 반복	반복
성립립	성립
9 9 9	9
9 9	9
갖쳐요	가져요
갖세요	가져요
되는되는	되는
되는되는되는	되는
사실이아요	사실이에요
있는아요	있어요
과과	과
세 세	세
<ARRW>	
<UNK>	 
